空空空空空空空空空空空空空
空砖空砖空砖空砖空砖空砖空
空砖空砖空砖空砖空砖空砖空
空砖空砖空砖空砖空砖空砖空
空砖空砖空砖空砖空砖空砖空
空空空空空空空空空空空空空
空空空空空空空空空空空空空
空空空空空空空空空空空空空
空空空空空空空空空空空空空
空空空空空空空空空空空空空
空空空空空空空空空空空空空
空空空空空砖砖砖空空空空空
空空空空空砖鸟砖空空空空空