空空空空空空空空空空空空空
空砖空砖空砖空砖空砖空砖空
空砖空砖空砖空砖空砖空砖空
空砖空砖空砖空砖空砖空砖空
空砖空砖空砖空砖空砖空砖空
空空空空空空空空空空空空空
空空空空空空空空空空空空空
空草草铁草草草草草草草草空
水水空水水水水水空水水水水
草草空铁空空空砖空空空空空
草草空空空空空空空砖水水砖
草草空空空砖砖砖空空空空空
空空空空空砖鸟砖空空空空空